%%%%%%%%%
%.P.....%
%.%%..%.%
%.o%..%.%
%..%..%.%
%..G..%.%
%.......%
%%%%%%%%%
